00000000000000000000
00000000000000000000
00000000000000000000
00000000000000000000
00000000000111110000
00000000000122210000
00111111111129211100
00122222222224222100
00123333999934445100
00122222222224222100
00111111111129211100
00000000000122210000
00000000000111110000
00000000000000000000
00000000000000000000
00000000000000000000
00000000000000000000
00000000000000000000
00000000000000000000
00000000000000000000