00000000000000000000
00000000000000000000
00000000000000000000
00000000000000000000
00000000011111110000
00000000012212210000
00000000012233210000
00001111112312210000
00001444111212211000
00001422122321221000
00001422223232321000
00001422122321221000
00001444111212211000
00001111112322210000
00000000015212210000
00000000011111110000
00000000000000000000
00000000000000000000
00000000000000000000
00000000000000000000